English Word	EN_ARTransliteration	French Word	FR_ARTransliteration
number	نامبر, نَمبَر, نمبر	numéro	نوميرو, نُوميرو, نومِرو
hotel	هوتيل, هوتل, هوتل	hôtel	أوتيل, هوتيل, أُوتيل
train	ترين, تران, ترينن	train	تران, تْران, ترين
restaurant	ريستورانت, رستورانت, ريستورنات	restaurant	رِستوران, رستوران, رِستورَان
name	نيم, نايم, نَيم	nom	نوم, نُم, نوم
water	واتر, وتر, ووتَر	eau	أُو, أو, أُو
yen	ين, يِن, ينن	yen	يَن, يِن, يَن
week	ويك, وييك, ويكك	semaine	سِمَن, سيمان, سِمَان
insurance	انشورنس, انسورانس, انشورانس	assurance	أسورَنس, أَسُرانس, أسورانس
month	مونث, مانث, منث	mois	موا, مويس, موا
red	ريد, رد, رِد	rouge	روج, رُوج, رُوج
possible	بوسبل, بوسيبل, بوزيبيل	possible	بوسيبل, پوسيبل, بُوسيبل
museum	ميوزيوم, موزيوم, ميوزيوم	musée	ميوزيه, موزه, ميوزِيه
door	دور, دوور, دورر	porte	بورت, بُورت, بورت
tea	تي, تيه, تيي	thé	تي, ثي, تي
white	وايت, واهت, وايتت	blanc	بلان, بْلان, بلان
stamp	ستامب, ستيمب, ستامب	timbre	تيمبر, تِمبر, تيمبِر
hospital	هوسبيتال, هاسبيتال, هوسبيتل	hôpital	أوبِتال, أُوبِيتال, هوبِتال
watch	واتش, ووتش, ووتش	montre	مونتر, مُونتر, مونتْر
pain , hurt	باين, هيرت, بين	douleur , mal	دولور, مال, دولور / مال
special	سبيشال, سبيشل, سبيشيال	spécial	سبيسيال, سبِسيال, سبيسيال
personal	بيرسونال, بيرسنال, بيرسونل	personnel	بيرسونيل, پيرسونيل, بيرسونيل
stay	ستاي, ستَي, ستاي	séjour	سيجور, سِيجور, سيجُور
fruit	فروت, فرووت, فرويت	fruit	فروي, فْرُوي, فروي
message	ميسج, مساج, ميساج	message	ميساج, مِيساج, ميساج
american	امريكان, اميركان, امريكَن	américain	أمريكان, أَمِريكَن, أمريكين
leather	ليذر, لاذر, ليتر	cuir	كُوير, كِوير, كوير
cold	كولد, كُولد, كولد	froid	فروآ, فرواد, فْرُوا
music	ميوزيك, موزيك, ميوزِك	musique	ميوزيك, موزيك, ميوزِيك
blanket	بلانكت, بلانكيت, بلانكِت	couverture	كوفيرتُر, كوفِرتور, كوفيرتُر
beach	بيتش, بيِتش, بيتش	plage	بلاج, بْلاج, بلاج
driver	دريفر, درايفر, دريفَر	chauffeur	شوفور, شاوْفور, شوفور
juice	جوس, جوسِ, جوس	jus	جو, جُوس, جو
market	ماركت, ماركِت, ماركِت	marché	مارشيه, مارشِه, مارشيه
tennis	تينيس, تنس, تينّس	tennis	تِنيس, تينيس, تِنِس
meeting	ميتينج, ميتينغ, متينج	réunion	ريونيون, رِيونيون, ريونيون
cheese	تشيز, تشيس, تشيزِ	fromage	فروماج, فْرُماج, فروماج
green	جرين, غرين, غرين	vert	ڤير, فير, ڤير
french	فرينش, فرنش, فرنش	français	فرانسيه, فرَنْسيه, فرانسيه
ham	هام, هامم, هام	jambon	جامبون, جَامبون, جامبُون
rice	رايس, ريس, رايس	riz	ري, رِيز, ري
opera	اوبرا, أوبرا, أوبيرا	opéra	أوبرا, أوبِرا, أوبيرا
account	اككاونت, اكّاونت, اككاونت	compte	كومبت, كُومبت, كومبت
direction	دايركشن, دايرِكشن, دايريكشن	direction	ديركسيون, دِيركسيون, ديركسيون
delicious	ديليشس, ديليشيوس, ديليشس	délicieux	ديليسيو, دِليسيُو, ديليسيُ
main	مين, ماين, مين	principal	برينسيبال, پرينسيبال, برينسيبال
magazine	ماجازين, ماگازين, ماجازين	magazine	ماجازين, ماغازين, ماجازِين
inch	انش, إنچ, إنش	pouce	بوس, بُوس, بوس
tip	تيب, تِب, تيب	pourboire	بوربوَار, پُوربُوار, بوربوير
pair	بير, باير, بير	paire	بَيِر, پير, بَيِر
fork	فورك, فوركك, فورك	fourchette	فورشيت, فورشِت, فورشيت
weekend	ويكند, ويكيند, ويكند	week-end	ويكند, ويك إند, ويكند
art	آرت, أرت, ارت	art	آرت, أَرْت, آرت
perfume	بيرفوم, برفوم, بيرفيوم	parfum	بارفان, پَارفان, بارفُوم
pepper	بيبر, بَبر, بيپر	poivre	بُوڤر, بُوفْر, بُوفر
prefer	بريفَر, بريفِر, بريفَر	préférer	پْرِفِرِه, بْريفِرِه, پْرِفيرِر
centimeter	سنتيمتر, سنتيميتر, سنتيمِتر	centimètre	سَنْتيمتر, سَنْتيمِتر, سَنْتيمتر
ocean	أوشن, أوسين, أوشِن	océan	أوسيان, أُوسيان, أوسِيان
ambulance	امبولانس, أمبولانس, أمبولانز	ambulance	أَمبولانس, أَمبُولَنس, أَمبولانس
pen	بن, پِن, بين	stylo	ستيلو, سْتيلو, ستيلو
wake	ويك, وِيك, ویک	réveiller	ريفاييه, رِيفاييه, ريفَيِه
express	اكسبريس, إكسپريس, اكسبريس	express	إكسبريس, إكسپريس, إكسبريس
souvenir	سُوفينير, سُوفنير, سُوفنير	souvenir	سُوفِنِير, سُوفَنير, سُوفِنير
fax	فاكس, فاکس, فكس	fax	فاكْس, فَكس, فاكْس
apple	آبل, أپل, أبّل	pomme	بوم, پوم, بوم
necessary	نيسسري, نيسيساري, نِسِسري	nécessaire	نِسِسير, نِسِيسير, نِسِسير
fresh	فريش, فريش, فريش	frais	فْرِيه, فريه, فْرِيه
zoo	زو, زوو, زُو	zoo	زو, زُو, زو
italian	ايتاليان, إيطاليان, إيتالين	italien	إيطاليان, إيطالي, إيطالين
language	لانغواج, لانجوِج, لنگويج	langue	لانغ, لَانغ, لانغ
summer	سمر, سامر, سَمَر	été	إتي, إِتي, إيتِه
chinese	تشاينيز, تشينيز, تشاينيز	chinois	شِينُوا, شِينواز, شِينُا
tomato	توماتو, تماطو, توماتو	tomate	تومات, تومَات, تومَات
blouse	بلوز, بلوُس, بلوزِ	chemisier	شوميزيه, شِمِزيه, شوميزيه
tomorrow	تومورو, تومورّو, تُمورو	demain , lendemain	دِمان, لاندِمَن, دِمان / لاندِمان
garden	جاردن, گاردن, جارڈن	jardin	جاردَن, جَردَن, جاردين
immigration	ايميجريشن, ايمِگريشن, امیگریشن	immigration	إِميغراسيون, إِميغراشيون, إِميغراسيون
temperature	تمبراتور, تمپرَتشر, تمپرَتير	température	تَمپِرَتُر, تَمبِرَاتُر, تَمپِرَاتُر
sick	سيك, سِك, سيك	malade	مالاد, مَلاد, مالاد
meter	ميتر, ميِتر, ميتر	mètre	مِتر, مِيتَر, مِتر
passport	باسپورت, پاسپورت, باسپُورت	passeport	پاسپور, بَاسپور, پاسپُورت
airport	ايربورت, ايربُورت, ايرپورت	aéroport	أيروبورت, أَيروبورت, أيروبورت
color	كولور, كالر, كولَر	couleur	كولور, كُلور, كولور
why	واي, وهاي, وائي	pourquoi	بوركوا, پُوركوا, بوركُوا
tax	تاكس, تاكْس, تاكس	taxe	تَكس, تاكس, تَكس
right	رايت, رایت, رايت	droite	درُوات, درُوت, درُوات
gate	گيت, گيتْ, گيت	dollar	دولار, دُولار, دولار
dollar	دولار, دولر, دُلار	réservation	ريزرفاسيون, رِزيرفاسيون, ريزرفاسيون
reservation	ريزيرفيشن, ريزرفيشن, ريزرفيشن	café	كافي, كَافيه, كافي
coffee	كوفي, قهوة, كوفي	carte	كارت, كَارت, كارت
card	كارد, كَرد, كارد	aider	إِدِيه, أيدِيه, إِدِيه
help	هيلب, هلب, هلب	chaussure	شوسور, شُوسور, شوسور
shoe	شو, شوو, شُو	accepter	أكسبتيه, أَكسپتيه, أكسبتيه
accept	أكسبت, أسبت, اكسبت	crédit	كريدِ, كْرِيدِ, كريدِ
credit	كريدت, كريديت, كريت	merci	ميرسي, مِرسي, ميرسي
thanks	ثانكس, ثانكْس, ثَانكس	service	سيرفيس, سِيرفِيس, سيرفيس
service	سيرفيس, سيرفِس, سرفيس	cigarette	سِغارِت, سِيجارِت, سِغارِت
cigarette	سيجريت, سيگارِت, سِجاريت	ici	إيسي, إِيسي, إيسي
here	هير, هِير, هِير	cravate	كرافات, كْرافات, كرافَت
tie	تاي, تَي, تايِ	appareil photo	أبارايِ فُوتو, أَپَارايِل فوتو, أبارايِل فوتو
camera	كاميرا, كامِرا, كاميرَا	minute	مينوت, مِينوت, مينُوت
minute	مِينت, مينِت, مِينت	question	كِسْتْيُون, كِسْتْيون, كِسْتِيُون
question	كويستشن, كويستِيون, كويستشن	mal de tête	مال دو تِت, مَال دو تِت, مال دو تيت
headache	هيديك, هِدَيك, هيديك	annuler	أنوليه, أَنوليه, أنولِيه
cancel	كانسل, كنسِل, كانسِل	décider	دِسِدِيه, دِسيدِيه, دِسِيديِه
decide	ديسايد, ديسِيد, ديسايد	où	أُو, أُو, أُو
where	وير, وِهَر, وِير	voiture	فُواتُر, فُواتور, فُواتر
car	كار, كَر, كارر	adresse	أدرس, أَدْرِس, أدرس
address	أدرس, أدريس, أدرِس	entrée	أَنْترِيه, أَنْتْرِيه, أَنْترِيه
entrance	انتْرانس, إنتْرانس, انتِرنس	budget	بُدجيه, بُودجيه, بُدجيه
budget	بَجدِت, بودجت, بَجِت	petit déjeuner	پتي دِژُونِيه, پِتِي دِژُونِيه, پتي دِژُونِيه
breakfast	بريكفاست, بريكفست, بريكفاست	sentir	سَنْتِير, سَنْتِر, سَنْتِير
feel	فيل, فِيل, فيل	vendre	فَندْر, فَندْر, فَندْر
sell	سيل, سِل, سيل	oeil	أُوِيل, أُوِيل, أُوِيل
eye	آي, اي, أي	se inquiéter	سْآنكيتِيه, سَانكيتِيه, سْآنكيتِيه
worry	ووري, وُرّي, ووري	accident	أكْسِيدَنْ, أكْسِيدَنْ, أكْسِيدَنْ
accident	أكسيدنت, اكْسِدِنت, اكْسيدِنت	commande	كُومَند, كُومَند, كُومَند
order	أوردر, أُردَر, أوردَر	montagne	مونتانْ, مونتاني, مونتانْ
mountain	ماونتين, ماونتن, مونتن	boeuf	بوف, بُوف, بوف
beef	بيف, بِيِف, بيف	savon	سَافون, سافُن, سَافُن
soap	صاب, سوب, سوب	bague	باگ, بَاغ, باگ
ring	رينج, رِنج, رينق	bus	بُوس, بوس, بُوس
bus	بس, بَس, بَسْ	local	لوكال, لُوكال, لوكال
local	لوكال, لوكَل, لوكال	comprendre	كومپْرَوندْر, كومپروندْر, كومپْرَوندْر
understand	أندرستاند, أندِرستاند, أندَرستاند	viande	فياند, فِياند, فياند
meat	ميت, مِيت, مِت	golf	غولف, گولف, غولف
golf	جولف, غولف, غولف	pain	پَنْ, پَان, پَنْ
bread	برِد, بريد, برِيد	légume	لِگُوم, ليغوم, لِگُوم
vegetable	فِجيتبل, فِجِتِبل, فيجيتبل	cocktail	كوكتيل, كوكْتِيل, كوكتِيل
cocktail	كوكتيل, كوكتايل, كُكتيل	steak	ستَيك, سْتِيك, ستَيك
steak	ستيك, ستيِك, ستِيك	copie	كوبِي, كُوبي, كوبِي
copy	كَوبي, كوبي, كُوبي	école	إيكول, إيكُول, إيكول
school	سكول, سكولل, سكول	homme	أُوم, أُوم, أُوم
man	مان, مَن, مان	étranger	إترانجيه, إتْرَانْجيه, إترانجيه
foreign	فورين, فورِن, فورِين	usage	يوزاج, يُوزاج, يوزاج
use	يوز, يوزِ, يوس	naturel	ناتوريل, ناتورَل, ناتوريل
natural	ناتشورال, ناتشورل, ناتشرال	vie	في, فِي, في
life	لايف, لَايف, لايِف	dîner	دِينِيه, دِينير, دِينِيه
dinner	دينر, دِنر, دِينَر	entendre	أَنْتَندر, أَنْتِندْر, أَنْتَندر
hear	هير, هِير, هِر	arrêt	أَرِي, أَرّيه, أَرِي
stop	ستوب, ستُب, ستوب	vue	فُو, فُو, فُو
view	فيو, فِيُو, فيو	manteau	مَنتو, مَنتو, مَنتُو
coat	كوت, كُوت, كوت	contrat	كُنترَ, كونتْرَا, كُنترَ
contract	كونتراكت, كونتراكت, كُنتراكت	vol	فُول, فُول, فُول
flight	فلايت, فِلَيت, فليت	livre	ليفر, لِيفر, لِفر
book	بوك, بُوك, بوك	acheter	آشِتِيه, أَشِتِيه, آشِتِيه
buy	باي, بَي, بايِ	classe	كلاس, كْلاس, كلاس
class	كلاس, كلاس, كِلَس	chemise	شَمِيز, شَمِيز, شَمِيز
shirt	شيرت, شِرت, شيرت	système	سِيسْتَم, سِستَم, سِيسْتَم
system	سيستم, سيسْتِم, سيستِم	regarder	رِگارْدِيه, رِغاردِيه, رِگارْدِيه
bacon	بيكون, بِيكون, بايكون	bacon	باكون, باكُن, باكون
pizza	بيتزا, بيتْزا, بيتسا	pizza	بيتزا, بيتزَا, بيتزا
plan	بلان, بْلان, پلان	projet	پروجيه, پروجي, پروجيه
point	بوينت, بُوينت, بُوِنت	point	پوان, بوان, پوان
arm	آرم, آرْم, أرَم	bras	برا, بْرا, برا
visit	فيزيت, فيزِت, فِزيت	visite	فيزيت, فيزِيت, فيزيت
history	هيستوري, هِستوري, هيستُري	histoire	إيسْتوار, إيستور, إِستوار
lock	لوك, لُوك, لوك	enfermer	أَنْفِرْمِيه, أَنْفِرْمِيه, أَنْفِرْمِيه
child	تشايلد, شيلد, تشايلد	enfant	أَنْفان, أَنْفَان, أَنْفان
room	روم, رُوم, روم	chambre	شَامبْر, شَمْبر, شَامبر
wear	وير, وِير, وير	porter	پورتيه, بُورتي, پورتيه
nearest , nearer	نيرست, نيرَر, نيرست	plus proche	بلُس بروش, بْلُس بروش, بْلُس بروش
friend	فريند, فرِند, فْريند	ami	أَمي, أَمِي, أَمي
egg	ايج, إِج, إج	oeuf	أُوف, أُوف, أُوف
side	سايد, سِيد, سايِد	côté	كوتي, كُوتي, كوتي
chicken	تشيكن, شِكن, تشيكن	poulet	پولييه, پولِي, پولييه
lunch	لانش, لَنش, لانش	visiter	فيزِيتِيه, فيزِيتي, فيزيتِيه
different	ديفِرنت, دِفرنت, ديفرِنت	déjeuner	دِژُونِيه, دِژُونِيه, دِژُونِيه
shower	شاور, شَوِر, شاور	différent	دِفِرَان, دِفِرَان, دِفِرَان
japanese	جابانِيز, جابانيس, جابانيز	douche	دوش, دُوش, دوش
country	كانتري, كَونتري, كانتري	japonais	جابونيه, جَابونِيه, جابونيه
new	نيو, نيوو, نُو	pays	پِيه, پايِس, پِيه
bottle	بوتل, بوتِل, بوتل	nouveau	نُوفو, نُوفو, نوفو
sugar	شوغر, شُجَر, شوگَر	bouteille	بوتييه, بوتَيِيه, بوتييه
word	وورد, وُرد, وُرد	sucre	سُكر, سُوكْر, سُكر
street	ستريت, ستريِت, ستريت	mot	مو, مُو, مو
trip	تريب, تْرِب, تريب	rue	رو, رُو, رو
forget	فورجِت, فورغِت, فورجِت	voyage	فُواياج, فُويَاج, فُواياج
manager	ماناجر, مَانَجَر, مانِجر	oublier	أوبليه, أُوبلي, أوبليه
night	نايت, نَايت, نيت	directeur	ديرِكْتُر, ديرِكتور, ديرِكتر
place	بليس, بْلِيس, بليس	nuit	نوي, نُوي, نوي
sure	شور, شُور, شُوَر	endroit	أَنْدْرُوَا, أَنْدْرُوا, أَنْدْرُوَا
court	كورت, كُورت, كُرْت	sûr	سُور, سُور, سُور
morning , a.m.	مورنينج, مورنِنج, مورنيج	court	كور, كُور, كور
salad	سالاد, سَلاَد, سالَد	matin	ماتان, مَاتِين, ماتان
fish	فيش, فِش, فِيش	salade	سالاد, سَالاد, سالاد
product	برودكت, برودِكت, برودِكت	poisson	بُواصون, بُوسون, بُواصون
double	دابل, دُوبل, دابل	produit	برُودُوي, برودوي, برُودُوي
meal	ميل, ميِل, مِيال	double	دُوبل, دُوبِل, دُوبل
doctor	دوكتور, دُكتور, دَكتَر	repas	رِپَا, رِپاس, رِپَا
police	بوليس, بولِس, بولِيس	médecin	مِدِسين, مِديسِين, مِدِسين
read	ريد, ريدِ, رِيد	police	بولِيس, بُولِيس, بولِيس
boat	بوت, بُوت, بوت	lire	لِير, لِير, لير
cash a check	كاش ا شيك, كاشْا شِك, كاش اشِك	bateau	باتو, بَاتو, باتو
sea	سي, سِي, سِ	encaisser un chèque	أَنْكَيسِيه أُن شِك, أَنْكَيسِي أُن شِك, أَنْكَيسِيه أُن شِك
slope	سلوب, سلوبِ, سلوب	mer	مِير, مير, مِير
letter	لتر, ليتر, لِتر	pente	پَانت, پَنْت, پَنت
hat	هات, هَت, هات	lettre	لِتر, لِتْر, لِتر
be	بي, بِ, بي	chapeau	شَاپو, شابُو, شَاپو
soup	سوب, سُوب, سوب	être	إِتر, إِتْر, إِتر
clothes	كلوز, كلوثس, كلُوز	soupe	سُوب, سوب, سُوب
receipt	ريسيت, رِسيت, ريسِت	vêtement	فِتْمَان, فِتمَان, فِتْمَان
dish	ديش, دِيش, ديش	reçu	رِسُو, رِسُو, رِسُو
wait	ويت, وَيت, وِيت	plat	پلات, پْلات, پلات
form	فورم, فُورم, فورم	attendre	أَتَندْر, أَتْنْدْر, أَتَندْر
theater	ثياتر, ثِيتر, ثياتِر	formulaire	فُورْمُولير, فُورمُولِير, فُورْمُولير
want , would like	وانت, وُلد لايك, ونت	théâtre	تِيآتْر, تيآتْر, تِيآتْر
wine	واين, وَاين, واین	vouloir	ڤُولُوَار, ڤولُوار, ڤُولُوَار
smoking	سموكينج, سموكِنغ, سموكِينج	vin	ڤان, ڤِين, ڤان
sit	سيت, سِت, سِت	fumer	فُومِيه, فُومِي, فُومِيه
borrow	بورو, بَرو, بَرُو	se asseoir	سْآسُوَار, سَآسُوَار, سْآسُوَار
best , better	بيست, بِتر, بستر	emprunter	أَنْپْرُونتِيه, أَمْپْرونتِيه, أَنْپْرُونتِيه
medicine	ميديسين, ميدِسين, ميدِسِن	meilleur	مِيلْيُور, مِيليور, مِيلْيُور
reserve	ريزيرف, رِزيرف, ريزِرف	médicament	مِدِيكَمَان, مِدِيكَمَان, مِدِيكَمَان
seem	سيم, سِيم, سيِم	réserver	رِيزِيرڤِيه, رِيزِيرڤِي, رِيزِيرڤِيه
operator	أوبيراتور, أوبيراتُر, أوبيريتور	sembler	سَامبِلِيه, سامبليه, سَامبِلِيه
explain	اكسبلين, إكسپلين, اكسبلِن	opérateur	أُوبِرَتُور, أوبيرَتُور, أُوبِرَتُور
depend	ديبند, دِبند, ديبِند	expliquer	إِكْسْپلِكِيه, إكْسْپلِكِي, إِكْسْپلِكِيه
program	بروغرام, بروغرام, بروغرام	dépendre	دِپَوندْر, دِپَوندْر, دِپَوندْر
table	تيبل, تِيبِل, تيبل	programme	پروغرام, بْرُوغْرام, پروغرام
appointment	ابوينتمنت, ابوينتِمنت, أبويْنتمنت	table	تابْل, تَابل, تابْل
stomach	ستومَك, ستُمَك, ستُمَك	rendez-vous	رَاندِڤو, رَانديفُو, رَاندِڤو
belt	بيلت, بِلْت, بِلْت	estomac	إِسْتُوماك, إستُوماك, إِسْتُوماك
steal	ستيل, سْتيل, سْتِل	ceinture	سَنتُر, سَنْتُور, سَنتُر
give	جِف, جيف, جِيف	voler	فُولِيه, فُولير, فُولِيه
seat	سيت, سِيت, سِت	donner	دُونِيه, دُنِيه, دُونِيه
paper	بيبر, بِيبر, بيپر	place	پلاس, بْلاس, پلاس
size	سايز, سِيز, سايِز	papier	پاپِيِيه, پاپييه, پاپِيِيه
speak , talk	سبيك, توك, سبيك	taille	تايِيه, تَايل, تايِيه
look for	لوك فور, لوكفور, لوك فور	parler	پَرْلِيه, پَارْلِيه, پَرْلِيه
maybe	مِيبّي, ميبي, مِيبي	chercher	شِرْشِيه, شَرْشِيه, شِرْشِيه
foot	فوت, فُوت, فوت	peut-être	پُو-تِتْر, پُو-تِتْر, پُو-تِتْر
case	كيس, كيسِ, كَيس	pied	پِيِيه, پيد, پِيِيه
bed	بيد, بِد, بَد	cas	كا, كَاس, كا
driver 's license	رخصة سائق, رِخصة سايك, رخصة درايفر	lit	لِي, لِيت, لِي
wonderful	وندر فول, وندرفول, وُنْدرفول	permis de conduire	پِرْمِيه دُو كُنْدُير, پِرْمِي دُو كُونْدُور, پِرْمِيه دُو كُنْدُير
plate	بليت, بلييت, بليت	merveilleux	مِيرڤِيو, مِيرڤِيُو, مِيرڤِيو
reconfirm	رِيكونفرم, رِيكونفِرم, رِيكونفورم	assiette	أَسِيِيه, أَسِيِت, أَسِيِيه
lipstick	ليبستيك, ليبسِتك, ليبستِك	reconfirmer	رِكُونفِيرمِيه, رِكُوفِيرمِيه, رِكُونفِيرمِيه
call	كول, كَال, كول	rouge à lèvre	رُوج آ لِيفر, رُوج آ لِڤر, رُوج آ لِيفر
platform	بلاتفورم, بلاتفُرْم, بلاتفورم	appel	أَپِل, أَپِل, أَپِل
fever	فيفر, فِيڤَر, فِيڤَر	quai	كِي, كِي, كِي
old	أولد, أُلد, أولد	fièvre	فِيِيفر, فِيڤر, فِيِيفر
play	بلاي, پْلاي, بلاي	vieux	ڤيو, ڤيُو, ڤيو
station	ستيشن, ستيشن, ستايشن	jouer	ژُوِيه, ژوييه, ژُوِيه
picture	بيكچر, بيكْتشر, پِكْتشر	gare	گار, غار, گار
line	لاين, لاين, لِين	photo	فوتو, فُوتو, فوتو
serve	سيرف, سِرف, سيرف	ligne	لِينْ, لِينْ, لِينْ
idea	آيديا, أيديا, آيدِيا	servir	سِرڤِيه, سِرڤير, سِرڤِيه
menu	مينيو, مِينُو, مينو	idée	إِدِيه, إِدي, إِدِيه
gift	جيفت, گِفت, گيفت	menu	مِينُو, مِينُو, مِينُو
pay	باي, پِي, باي	cadeau	كادُو, كادو, كادُو
guide	جايد, گايد, گاید	payer	پايِيه, پَيِيه, پايِيه
date	ديت, دِيت, دِيت	guide	گِيد, گايد, گِيد
there	ذير, ذِير, ذَر	date	دات, دات, دات
day	داي, دَي, داي	là-bas	لا-بَ, لا-بَا, لا-بَ
people	بيبول, بيپول, بيپِل	jour	ژُور, جور, ژُور
subway	سَبواي, سَب وِي, سبواي	gens	ژَان, جَان, ژَان
baggage , luggage	باچيج, لوجِ, باچِج	métro	مِيترو, ميترو, مِيترو
cent	سنت, سينت, سِنت	bagage	بَاغَاج, باݢاج, بَاغَاج
light	لايت, لَايت, ليت	centime	سَنْتِيم, سَنْتِيم, سَنْتِيم
price tag	برايس تاج, برايستاج, برايس تَاج	bon	بُن, بون, بُن
put	بوت, پُت, پوت	léger	لِيجِيه, لِجِير, لِيجِيه
beer	بير, بِيِر, بير	étiquette de prix	إِتِكِيت دُ پْرِيس, إِتِكِيت دُ بْرِيس, إِتِكِيت دُ پْرِيس
aisle	آيل, آيل, آيِل	mettre	مِتْر, مِتّر, مِتْر
hair	هير, هِير, هير	bière	بِير, بِيِير, بِير
wonder	وندر, وُنْدر, وندر	couloir	كُولُوار, كولوار, كُولُوار
join	جوين, جُوين, جوين	cheveu	شِڤو, شڤو, شِڤو
end	إند, إندْ, إند	demander	دِمَندِيه, دِمَندِي, دِمَندِيه
family	فاميلي, فَمِلي, فاميلي	droit	دْرُوت, دْرُوات, دْرُوت
building	بيلدينج, بِلْدينج, بيلدينج	joindre	جُويندْر, جُوِيندْر, جُويندْر
what time	ووت تايم, وات تايم, وُت تايم	bout	بوت, بُوت, بوت
break	بريك, بْريك, بريك	famille	فامي, فامِيل, فامي
plane	بلاين, پْلين, بلاين	bâtiment	باتِمان, باتِمَان, باتِمان
start	ستارت, سْتارت, ستارت	aide	إيد, آيد, إيد
send	سيند, سِند, سيند	à quelle heure	آ كيل إر, آ كيل أور, آ كيل إر
pound	باوند, پَوند, پَونْد	casser	كاسيه, كَاسِيه, كاسيه
ready	ريدي, رِيدي, ريدي	avion	أفِيُون, آفْيون, أفِيُون
dress	دِريس, دريس, دْريس	commencer	كومَنْسِيه, كُومَنسِي, كومَنْسِيه
club	كلوب, کْلوب, كْلوب	envoyer	أَنْڤُوِيِيه, أَنْڤوِي, أَنْڤُوِيِيه
season	سيزون, سِيِزون, سيزِن	prêt	برِيه, بريه, برِيه
customs	كَستمز, كَسْتُمز, كستمز	robe	روب, رُوب, روب
lens	لينز, لِنز, لينس	club	كْلوب, كْلُوب, كْلوب
center	سنتر, سينتر, سنتر	saison	سِيزُون, سِيزُن, سِيزُون
prescription	بريسكريبشن, بريسْكريبشن, بريسِكريبشن	douane	دُوان, دُوان, دُوان
map	ماب, مَاب, مَپ	lentille	لَنْتِيه, لَنْتيل, لَنْتِيه
good	جود, گُود, جُود	centre	سانتر, سَنتْر, سانتر
key	كي, كِي, كِي	ordonnance	أُوردُونَس, أُوردُونَس, أُوردُونَس
do you mind	دو يو مايند, دو يو مَيند, دو يو مَيند	plan	پلان, پلان, پلان
problem	بروبلم, پروبلم, برُبلم	clé	كلي, كْلِيه, كلي
bath	باث, بَاث, باث	ça vous déranger	سا ڤو دِرانجِيه, سا ڤو دِرانج, سا ڤو دِرانجِيه
game	غايم, جيم, غيم	problème	بروبْلِم, بروبْلِم, بروبْلِم
include	إنكلود, إنكْلود, إنكلود	baignoire	بَيْنْوَار, بَيْنْوَار, بَيْنْوَار
milk	ميلك, مِلْك, ميلك	match	ماتش, ماتش, ماتش
hot	هوت, هُوت, هوت	lait	لِيه, لَيت, لِيه
office	أوفيس, أُوفيس, أوفِس	chaud	شو, شُو, شو
hand	هاند, هَاند, هاند	bureau	بْيُورُو, بُورُو, بْيُورُو
return	ريتورن, رِترن, ريتُرن	main	مَان, مِين, مَان
elevator	إليفيتور, إليفاتور, إليفِيتور	retour	رِتُور, رِتُور, رِتُور
business	بزنيس, بيزنس, بزنِس	ascenseur	أَسانسور, أَسانسور, أَسانسور
find	فايند, فَيند, فِيند	affaire	أفْير, أَفِير, أفْير
wallet	وولت, والِت, وولِت	trouver	تْرُوفِيه, تُرُوفِي, تْرُوفِيه
bank	بانك, بَنْك, بانك	arrêter	أَرِتِيه, أَرِرِيه, أَرِتِيه
see	سي, سِي, سِ	portefeuille	بُورْفِيوي, بُورفُوي, بُورْفِيوي
suggest	سجست, سجِست, سَجست	banque	بَنْك, بَانك, بَنْك
floor	فلور, فْلور, فلور	voir	فُوار, فُوَر, فُوار
city , town	سيتي, سِتي, ستي	suggérer	سُجِرِيه, سُجِيرِيه, سُجِرِيه
go	جو, غو, گو	étage	إِتَاج, إِتاج, إِتَاج
lose	لوز, لُوز, لوز	ville	ڤيل, ڤيل, ڤيل
hope	هوب, هُوب, هوب	aller	آليِيه, آلِيه, آليِيه
keep	كيب, كِيب, كيپ	perdre	پِرْدْر, پِرْدْر, پِرْدْر
jacket	جاكيت, جاكِت, جاكِيت	espérer	إِسْپِرِيه, إِسْپِيرِيه, إِسْپِرِيه
bring	برينج, بِرينج, برِينج	garder	گارديِيه, گاردي, گارديِيه
drink	درينك, دِرينك, درنك	veste	ڤِسْت, ڤِسْت, ڤِسْت
eat	إيت, إِيِت, إيت	apporter	آپورتيِيه, آپورتي, آپورتيِيه
like	لايك, لايِك, لايك	boire	بُوار, بُوَار, بُوار
ask	آسك, أَسك, أسك	manger	مانجيِيه, مانجي, مانجيِيه
exchange	إكسشينج, إكستشينج, إكشانج	aimer	إِيمِيه, إيمِي, إِيمِيه
tour	تور, تَور, تور	change	شَانج, شَانج, شَانج
rent	رنت, رِنت, رِنْت	excursion	إِكسكُرْسْيُون, إِكسكُرسْيُون, إِكسكُرْسْيُون
departure	ديبارتشر, دِبارتشر, ديبَرْتشر	louer	لُوِيِيه, لُوِي, لُوِيِيه
mistake	ميستيك, ميستِك, ميستيك	départ	دِپَار, دِبَار, دِپَار
battery	باتري, بَتري, باتِري	erreur	إِرُور, إِرُور, إِرُور
cream	كريم, كْريم, كْرِيم	pile	بيل, بيل, بيل
company	كومباني, كَمباني, كومبني	crème	كْرِيم, كْرِيم, كْرِيم
box	بوكس, بَكس, بُكس	compagnie	كومپانِي, كومپانِي, كومپانِي
something , thing	سَمْثينج, ثينج, ثِينج	boîte	بُوات, بُوات, بُوات
work	وورك, وُرك, ورك	chose	شُوز, شُوز, شُوز
dessert	ديسِرت, ديسيرت, ديزيرت	travail	تْرَافاي, تْرَافاي, تْرَافاي
arrive	أريف, أرْايف, أريف	dessert	دِسِر, دِسير, دِسِر
small , little	سمول, ليتل, صْمول	arriver	آريفِيه, أريفِي, آريفِيه
press	بريس, بْرس, بريس	petit	پْتِي, پْتِي, پْتِي
tourism	توريسم, تورِزم, توريزم	appuyer	آپُويِيه, أپويِيه, آپُويِيه
follow	فولو, فَلو, فلو	tourisme	تُوريسْم, تُورِسْم, تُوريسْم
list	ليست, لِست, ليست	suivre	سُويْڤر, سُويْفْر, سُويْڤر
international	إنترناشونال, إنتِرنَشونال, إنترنشنال	liste	لِست, لِست, لِست
exit	إكزيت, إِكسِت, إكزِت	international	إِنْتِرنَشُونَال, إِنترناسيُونَال, إِنْتِرنَشُونَال
front	فرونت, فْرونت, فرونت	sortie	سُورتي, سُورتي, سُورتي
single	سينجل, سِنجل, سينْجل	en face de , face à	أَنْ فَاسْ دُ, فَاسْ آ, أَنْ فَاسْ دُ
part	بارت, بَرت, بارت	simple	سيمبل, سِيمْبل, سيمبل
mile	مايل, مَيل, مايل	partie	پَارْتِي, پَارْتِي, پَارْتِي
great	غريت, غْريت, جريت	utiliser	يُتِيلِيزِيه, يُتِيلِي, يُتِيلِيزِيه
drop	دروب, دْروب, دروب	mille	مِيل, مِيل, مِيل
happen	هابِن, هبِن, هابن	boisson	بُوَيسُون, بُوَسُون, بُوَيسُون
change	تشينج, تشينج, تشينج	génial	جِنِيَال, جِينْيال, جِنِيَال
department	دبارتمنت, ديبارتمنت, ديپارتمنت	tomber	تومبِيه, تومبِي, تومبِيه
fill	فيل, فِل, فيل	passer	پَاسِيه, پَاسِي, پَاسِيه
ticket	تيكِت, تِكت, تيكت	monnaie	مُونِي, مُونِي, مُونِي
other	أذر, أُذر, أذَر	rayon	رِيهُون, رِيهْيون, رِيهُون
long	لونج, لُونج, لونج	remplir	رَمْپْلِير, رَمْپْلِي, رَمْپْلِير
price , rate	برايس, ريت, برايس	billet	بِييِيه, بِلِيه, بِييِيه
have	هاف, حاف, هاف	autre	اوتر, أُوتر, اوتر
by the way	باي ذا واي, بِذَ واي, باي ذا واي	long	لُونغ, لُونغ, لُونغ
how much	هاو ماتش, هاو مُتش, هاو ماتش	prix	پْرِي, پْرِي, پْرِي
open	أوبن, أُپن, أوبِن	devoir	دِفُار, دِفُوَار, دِفُار
afternoon , p.m.	آفترنون, آفترنُن, أفترنون	au fait	أُ فَي, أُ فِيت, أُ فَي
next	نيكست, نِكست, نيكس	combien	كُمْبْيَن, كُمْبِيَن, كُمْبْيَن
information	إنفورميشن, إنفورمِيشِن, إنفورمشن	ouvrir	أُوفْرِير, أُوفِر, أُوفْرِير
full	فول, فُل, فُول	après-midi	أَپْرِه مِدِي, أَپْرِه مِدِي, أَپْرِه مِدِي
finish	فينش, فِنِش, فينِش	prochain	پْرُوشَان, پْرُوشِين, پْرُوشَان
taxi	تاكسي, تاكْسِي, تاكسي	commander	كومَنْدِيه, كُمَاندِي, كومَنْدِيه
moment	موومنت, مومنت, مُومنت	information	أَنْفُورمَاسِيُون, أَنْفُورمَاشِيُون, أَنْفُورمَاسِيُون
time	تايم, تايم, تَيم	complet	كومپليه, كومپلي, كومپليه
know	نو, نُو, نو	finir	فِينِير, فِينِير, فِينِير
do	دو, دُو, دو	taxi	تَاكْسِي, تاكْسِي, تَاكْسِي
tooth	توث, تْوث, توث	moment	مُومَان, مُومَنْ, مُومَان
traveler check	تراڤيلَر تشيك, تراڤِلر تشِك, تراڤِلَر تشِك	temps	تَنْ, تَمْ, تَنْ
bag	باج, بَگ, باق	savoir , connaître	سَافُوار, كُونَتْر, سَافُوار / كُونَتْر
available	آفيلابل, أفِيلابل, آفِيلابل	faire	فِير, فِير, فِير
laundry	لاندري, لاندري, لَونْدري	dent	دَنْ, دَنْ, دَنْ
food	فود, فُود, فُوْد	chèques-voyages	شِك-فُوياج, شِك-فُويَاج, شِك-فُوياج
leave	ليف, لِيف, لِيف	sac	ساك, سَاك, ساك
too , also	تو, ألْسو, تو	disponible	دِيسْپُونِيبِل, دِيسپُونِيبِل, دِيسْپُونِيبِل
last	لاست, لَست, لست	linge	لَنْج, لَنْج, لَنْج
hour	آور, أَوْر, أور	changer	شَانجِيه, شَانجِي, شَانجِيه
need	نيد, نِيد, نيد	cuisine	كوزين
money	موني, مُوني, مَوني	partir	بارتير
show	شو, شُو, شو	aussi	أوسي
lady	ليدي, لِيدي, لَيدي	dernier	ديرنييه
style	ستايل, سْتايل, ستايل	heure	إر
pharmacy	فارماسي, فَارماسي, فارمَسي	falloir	فالوار
report	ريبورت, رِيبورت, ريبُورت	argent	أرجون
try	تراي, تْراي, تراي	spectacle	سبيكتاكل
enjoy	إنجوي, إِنْجوي, إنجوي	dame	دام
person	بيرسون, پِيرسون, بيرسون	style	ستايل
party	بارتي, پارتي, بارتي	pharmacie	فارماسِي
movie , film	موفي, فيلم, موڤي	rapport	رابور
post , mail	بوست, ميل, بُوست	essayer	إسّييه
way	واي, وَاِي, واي	apprécier	أبرسييه
turn	تيرن, تُرن, تْرن	personne	بيرسون
glass	غلاس, گلاس, غْلاس	fête	فِيت
then , so	ذِن, سو, ذن	film	فيلم
live	ليف, لايف, لِيف	poste	بوست
mean	مين, مِين, مين	chemin	شَمن
show me	شو مي, شُو مي, شو مي	tourner	تورنيه
house	هاوس, هَوس, هاوس	verre	فير
phone , telephone	فون, تيليفون, فون	alors , donc	ألور ، دونك
let	لت, لِت, لت	vivre	فيفر
bill	بيل, بِل, بيل	vouloir dire	فولوار دير
tonight	تونيت, تُونيت, تونِيت	montres moi	مونتر مَوا
year	يير, يِير, يِر	marcher , travailler	مارشيه ، تراڤاييه
discount	ديسكاونت, ديسكاونت, دِسكاونت	appeler , rappeler	آبليه ، رابليه
kind	كايند, كايند, كايند	maison	ميزون
say	ساي, سَي, ساي	téléphone	تيليفون
package	باكيج, پَاكِج, باكِج	laisser	لاسيه
write	رايت, رِايت, رايت	note	نوت
come	كوم, كُم, كوم	ce soir	سُ سوار
think	ثينك, ثِنك, ثينك	an , année	آن ، آنّي
take	تيك, تايك, تايك	remise	ريميز
store , shop	ستور, شوب, ستور	genre	جونر
just , only	جست, أونلي, جست	dire	دير
large	لارج, لارج, لارج	paquet	باكيه
have , get	هاف, گِت, هاف	écrire	إكريه
make a call	ميك أ كول, ميك أ كَال, ميك أ كول	venir	فُنيه
tell	تل, تِل, تل	croire	كرواه
check	تشيك, چِك, تشيك	prendre	بروندغ
stay , remain	ستاي, رِمين, ستاي	magasin	ماگازان
beautiful	بيوتيفول, بيوتِفول, بِيُوتيفول	seulement	سولي مان
recommend	ريكوميند, ريكُميند, ريكومِند	grand	غْران
please	بليز, پليز, بليز	avoir	أفوار
excuse me	إكسكيوز مي, إكسكْيوز مي, إكسكيوز مي	passer un appel	پاسيه أَنْ آپل
sorry	سوري, سَوري, سوري	indiquer	أَنْديكيه
today	توداي, تُوداي, توْداي	vérifier	فِيريفييه
now	ناو, نَاو, نَاو	rester	رِستيه
very	فري, ڤِري, فيري	beau	بو
well	ويل, وِل, ويل	recommander	ريكومانديه
o'clock	أوكلوك, أُوكلوك, أوكلوك	s' il vous plait , veuillez	سِيل ڤو پلِيه ، ڤويييه
ah!	آه, أَه, آه	demain	دومَن
as soon as	آز سون آز, آز سُن آز, آز سونأز	excuser moi	إكسكوزه موا
is ... true ?	إز ... ترو؟, إز ... تْرو؟, إز ... تْرُو؟	désoler	ديزوليه
could you ... ? , can you ... ?	كود يو ...؟, كان يو ...؟, كود يو ...؟	aujourd'hui	أوژوردوي
darn	دارن, دَارن, دارن	maintenant	مَنتْنان
duty-free	ديوتي فري, دُوتي فري, ديوتي فْري	très	تري
even	إيفن, إيفِن, إيفن	eh bien	إه بيان
good evening	جود إيفنينج, جُود إيفنينج, جود إِفنينج	ah!	آه!
farewell	فَيرويل, فَير وَل, فَيرْوِل	dès que	دِ ك
few	فيو, فُو, فِيُو	est -ce que ... ?	إيه-س ك ...؟
in front	إن فرونت, إن فْرونت, إنْ فرونت	peux -tu ... ?	بُ تو ...؟
hello	هيلو, هَيلو, هِيلو	zut	زُت
hey	هي, هِي, هاي	hors taxe	هُور تاكس
most , more	موست, مور, مَوست	même	مِم
most	موست, مُوست, مَست	bonsoir	بونسوار
must , should	مست, شود, مُست	adieu	آديو
not	نوت, نُت, نَت	quelque	كِلْكُ
did not	ديد نوت, دِد نوت, دِد نَت	devant	دِوَان
will not	ويل نوت, وِل نوت, وِل نَت	bonjour	بونژور
get off	جِت أوف, جِت أُوف, جت أوف	hé!	هِه!
oh!	أوه!, أُه!, أوه!	plus	پْلُوس
okay	أوكاي, أُوكاي, أوكي	la plupart	لا پلُبَار
go out	جو آوت, غُو آوت, جو آوت	ne pas	نِه پَ
pardon , excuse me	بارْدِن, إكسكيوز مي, بارْدِن / إكسكيوز مي	descendre	دِسوندغ
percent	بيرسنت, پِرسنت, بِرسنت	oh!	أُه!
quarter	كوارتر, كُوارتَر, كوارتر	ok	أوك
someone	سَموان, سَم وُن, سَموان	sortir	سورتيه
such	سَتش, سَتش, سَتش	pardon	پاردون
uh!	أه!, أَه!, أه!	pour cent	پُور سَنْ
get up	جِت أب, جِت أَب, جِت أب	quart	كَر
what	وات, وُت, واهت	quelqu'un	كِلْكُون
when	وِن, وِين, وِن	tel que	تِل كُ
which	وِتش, وِتش, وِچ	euh!	أُه!
will , shall	ويل, شَل, ويل	se lever	سُ لِوِه
wow	واو, وَاُو, وَاو	quoi	كُوا
yes , yeah	يَس, يِيَه, يَس	quand	كُان
zero , o	زيرو, أُو, زيرو	quel	كِل
one	وَنْ, وَن, وُن	wouaou	وُاو
two	تو, تُو, تو	oui , ouais	ووي ، ووي
three	ثري, ثْري, ثْرِي	zéro	زِيرو
four	فور, فُور, فْور	un	أَنْ
five	فايف, فَايف, فايڤ	deux	دُو
six	سِكس, سكس, سِكس	trois	تْرُوآ
seven	سيفن, سِفن, سِڤن	quatre	كَتْر
eight	إيت, آيت, إِيْت	cinq	سانك
nine	ناين, نَين, نَين	six	سِيس
ten	تين, تِن, تين	sept	سِت
eleven	إلفن, إِلفِن, إيلفِن	huit	هُيت
twelve	تويلف, تْوِلف, تويلڤ	neuf	نُوف
thirteen	ثيرتين, ثَرْتِين, ثيرتين	dix	دِيس
fourteen	فورتين, فُورْتِين, فورتين	onze	أُونْز
fifteen	فيفتيِن, فِفْتِين, فيفْتِين	douze	دُوز
sixteen	سِكستين, سِكْسْتِين, سِكستين	treize	تْرِيز
seventeen	سيفنتين, سِفِنْتِين, سيفنتين	quatorze	كاتورز
eighteen	إيتين, إِيتِين, آيتين	quinze	كَنْز
nineteen	نينتين, نِينْتِين, نينتين	seize	سِيز
twenty	توينتي, تْوِنْتِي, توينتي	dix-sept	دِيس سِت
twenty-one	توينتي وَنْ, توينتي وَن, توينتي وُن	dix-huit	دِيس هُيت
twenty-two	توينتي تو, توينتي تُو, توينتي تو	dix-neuf	دِيس نُوف
twenty-three	توينتي ثري, توينتي ثْري, توينتي ثري	vingt	ڤِين
twenty-four	توينتي فور, توينتي فُور, توينتي فور	vingt-et-un	ڤِين تي أَنْ
twenty-five	توينتي فايف, توينتي فَايف, توينتي فايف	vingt-deux	ڤِين دُو
twenty-six	توينتي سكس, توينتي سِكس, توينتي سكس	vingt-trois	ڤِين تْرُوآ
twenty-seven	توينتي سِڤن, توينتي سيفن, توينتي سيفِن	vingt-quatre	ڤِين كَتْر
twenty-eight	توينتي إيت, توينتي آيت, توينتي إِيْت	vingt-cinq	ڤِين سانك
twenty-nine	توينتي ناين, توينتي نَين, توينتي نين	vingt-six	ڤِين سِيس
thirty	ثيرتي, ثْرِتِي, ثيرتي	vingt-sept	ڤِين سِت
forty	فورتي, فُورْتِي, فورتِي	vingt-huit	ڤِين هُيت
fifty	فِفتي, فِفْتِي, فِفتي	vingt-neuf	ڤِين نُوف
sixty	سِكستي, سِكْسْتِي, سِكستي	trente	ترونت
seventy	سِڤنتي, سِفِنْتِي, سِڤِنْتِي	quarante	كارونت
eighty	إيتِي, إِيْتِي, آيتِي	cinquante	سانكونت
ninety	ناينتي, نَينْتِي, نينتي	soixante	سواسونت
one hundred	وَنْ هاندْرِد, وَن هَندْرِد, وَنْ هاندرد	soixante-dix	سواسونت دِيس
one thousand	وَنْ ثاوزند, وَن ثاوزند, وَنْ ثاوزند	quatre-vingts	كاتر ڤِين
ten thousand	تِن ثاوزند, تِن ثاوزند, تِن ثاوزند	quatre-vingt-dix	كاتر ڤِين دِيس
one hundred thousand	وَنْ هاندرد ثاوزند, وَن هاندرد ثاوزند, وَنْ هاندرد ثاوزند	cent	سَنْ
one million	وَنْ ميلين, وَن ميلين, وَنْ ميلين	dix-mille	دِيس ميل
one billion	وَنْ بيلين, وَن بيلين, وَنْ بيلين	cent-mille	سَنْ ميل
zeroth	زيروث, زِيروث, زيروث	million	ميليُون
first	فيرست, فِرست, فيرست	milliard	ميليار
second	سكند, سِكند, سكند	premier	پْرِمييه
third	ثيرد, ثِرد, ثيرد	deuxième	دُزيم
fourth	فُورث, فورث, فُورث	troisième	تْرُوِزييم
fifth	فيفث, فِفث, فيفث	quatrième	كاترزييم
sixth	سِكث, سِكْسث, سِكث	cinquième	سانكيم
seventh	سِڤنث, سِفنث, سِڤِنث	sixième	سِزييم
eighth	إيتث, إِيْتث, آيتث	septième	سِتيم
ninth	ناينث, نَينث, نينث	huitième	هُويتييم
tenth	تينث, تِنتث, تينث	neuvième	نُوفييم
eleventh	إلفنث, إِلفنث, إيلفِنث	dixième	ديسييم
twelfth	تويلفث, تْوِلفث, تويلڤث	onzième	أُونزييم
thirteenth	ثيرتينث, ثَرْتِينث, ثيرتينث	douzième	دُوزييم
fourteenth	فورتينث, فُورْتِينث, فورتينث	treizième	تْرِيزييم
fifteenth	فيفتيِنث, فِفْتِينث, فيفْتِينث	quatorzième	كاتورزييم
sixteenth	سِكستينث, سِكْسْتِينث, سِكستينث	quinzième	كَنْزييم
seventeenth	سيفنتينث, سِفِنْتِينث, سيفنتينث	seizième	سِزييم
eighteenth	إيتينث, إِيتِينث, آيتينث	dix-septième	دِيس سِتيم
nineteenth	نينتينث, نِينْتِينث, نينتينث	dix-huitième	دِيس هُويتييم
twentieth	توينتياث, توينتياث, توينتياث	dix-neuvième	دِيس نُوفييم
twenty-first	توينتي فيرست, توينتي فِرست, توينتي فرست	vingtième	ڤِينتييم
twenty-second	توينتي سكند, توينتي سِكند, توينتي سكند	vingt et unième	ڤِين تي أُونِييم
twenty-third	توينتي ثيرد, توينتي ثِرد, توينتي ثيرد	vingt-deuxième	ڤِين دُوزِييم
twenty-fourth	توينتي فورث, توينتي فُورث, توينتي فورث	vingt-troisième	ڤِين تْرُوآزييم
twenty-fifth	توينتي فيفث, توينتي فِفث, توينتي فيفث	vingt-quatrième	ڤِين كاترزييم
twenty-sixth	توينتي سِكث, توينتي سِكث, توينتي سِكث	vingt-cinquième	ڤِين سانكييم
twenty-seventh	توينتي سِڤنث, توينتي سِڤنث, توينتي سِفنث	vingt-sixième	ڤِين سِزييم
twenty-eighth	توينتي إيتث, توينتي إِيْتث, توينتي آيتث	vingt-septième	ڤِين سِتيم
twenty-ninth	توينتي ناينث, توينتي نَينث, توينتي نينث	vingt-huitième	ڤِين هُويتييم
thirtieth	ثيرتيث, ثْرِتِيث, ثيرتيث	vingt-neuvième	ڤِين نُوفييم
fortieth	فورتيث, فُورْتِيث, فورتِيث	trentième	تْرُونتييم
fiftieth	فِفتيث, فِفْتِيث, فِفتيث	quarantième	كارُونتييم
sixtieth	سِكستياث, سِكْسْتِياث, سِكستياث	cinquantième	سانكونتييم
seventieth	سِڤنتياث, سِڤِنْتِياث, سِڤنتياث	soixantième	سواسونتييم
eightieth	إيتِياث, إِيْتِياث, آيتِياث	soixante-dixième	سواسونت دِيسيم
ninetieth	ناينتياث, نَينْتِياث, نينتياث	quatre-vingtième	كاتر ڤِينتيم
hundredth	هاندردث, هَاندْرِدث, هاندردث	quatre-vingt-dixième	كاتر ڤِين دِيسيم
thousandth	ثاوزندث, ثاوزندث, ثاوزندث	centième	سَنْتييم
ten thousandth	تِن ثاوزندث, تِن ثاوزندث, تِن ثاوزندث	millième	مِلييم
hundred thousandth	هاندرد ثاوزندث, هَاندرد ثاوزندث, هاندرد ثاوزندث	dix-millième	دِيس مِلييم
millionth	ميلينث, ميلينث, ميلينث	cent-millième	سَنْ مِلييم
billionth	بيلينث, بيلينث, بيلينث	millionième	ميليونييم
aboard	أبورد, أَبورد, أبورد	milliardième	ميلياردييم
about	أباوت, أَبَوت, أباوت	quatre-vingt	كاتر ڤِين
above	أبوف, أَبُوف, أبوف	à bord	أَ بورد
across	أكروس, أَكْروس, أكروس	environ	أَنْڤيرون
after	آفتر, أَفتر, آفتر	au-dessus	أُو-ديسو
all	أول, أُل, أول	de l' autre côté	دو لاوتر كُوتي
along	ألونج, أَلونج, ألونج	après	أپْرِه
among	أمانج, أَمونج, أمانج	tout	تُو
and	أند, أَنْد, أند	au long	أُو لُونغ
then	ذِن, ذِن, ذِن	parmi	پَارمي
another	أناذر, أَناءر, أناذر	et	إت
around	أراوند, أَرَوند, أراوند	ensuite	أَنْسُويت
as	آز, أَز, آز	vers	ڤير
at	آت, أَت, آت	comme	كُوم
because	بِي كوز, بِكوز, بِي كوز	à	أَ
before	بيفور, بِفور, بيفور	chez	شِيه
behind	بِهيند, بَهيند, بِهيند	parce que	پَرس كُ
beside	بِسايد, بَسايد, بِسايد	avant	أڤَان
between	بتوين, بِتْوين, بتوين	derrière	دِرْيير
but	بت, بَت, بت	près	پْرِيه
by	باي, بِي, باي	entre	أَنْتر
during	دورانج, دُورينج, دورانج	mais	مِه
each	إيتش, إِتش, إِيتش	par	پَار
every	إيفري, إِفري, إِفْري	pendant	پَنْدَان
except	إكسِبت, إكسبت, إكسِبت	chaque	شَك
for	فور, فُور, فُر	sauf	سُوف
from	فروم, فْروم, فروم	pour	پُور
if	إِف, إف, إِف	de	دُ
in , into	إن, إنتو, إِن	si	سِي
inside	إنسايد, إِنسايد, إنسايد	dans	دان
near	نير, نِير, نير	à l' intérieur	أَ لَنتِريور
no	نو, نُو, نو	non	نُون
of	أوف, أُوف, أوف	baisser le prix	بيسيه لو پْري
take off	تيك أوف, تاك أوف, تيك أُوف	sur	سور
on	أون, أُن, أون	ou	أُو
or	أور, أُور, أور	à l' extérieur	أَ لِكسطيريور
outside	أوتسايد, أُوتسايد, أوتسايد	plus de	پْلُوس دُ
over	أوفر, أُوفر, أوفر	en plus de	أَنْ پْلُوس دُ
plus , in addition to	بلس, إن أديشن تو, بلس	depuis	دِپوي
since , ago	سينس, أغو, سينس	du , quelque	دُ ، كِلْكُ
some	سام, سُم, سام	que	كُ
that	ذات, ذَت, ذات	le	لو
the	ذي, ذِي, ذي	jusque	ژُسک
go through , cross	جو ثرو, كروس, جو ثرو / كروس	sous	سُو
till , until	تِل, أَنْتيل, تِل / أَنْتيل	avec	أڤيك
to	تو, تُو, تو	sans	سان
toward	توورد, تُوورد, توورد	je	ژُ
under	أندر, أَنْدَر, أندر	me	مُ
whether	وِذَر, وذَر, وِذَر	le mien , la mienne , les miens , les miennes	لو ميَن ، لا ميَن ، لِ ميان ، لِ ميَن
while	وايل, وَايل, وايل	mon , ma	مُن ، مَا
with	وِذ, وِث, وذ	moi-même	مُا-مِم
within	وِذِن, وذِن, وِذِن	nous	نُ
without	وِذاوت, وذآوت, وِذاوت	le nôtre , la nôtre , les nôtres	لو نُوتر ، لا نُوتر ، لِ نُوتر
I	آي, أَي, آي	nôtre	نُوتر
me	مي, مِي, مي	nous-même	نُو-مِم
mine	ماين, مَين, ماين	tu	تُ
my	ماي, مَاي, ماي	ton	تُوْن
myself	ماي سيلف, مَاِي سيلف, ماي سِلف	te	تُ
we	وي, وِي, وي	toi	تُوا
us	آس, أُس, آس	le tien , la tienne , les tiens , les tiennes	لو تيَن ، لا تيَن ، لِ تيان ، لِ تيان
ours	أورز, أُرز, أورز	toi-même	تُوا-مِم
our	أور, أُور, أور	ta , ton	تَا ، تُوْن
ourselves	أورسِلفز, أُرسِلفز, أورسِلفز	vous	ڤو
you	يو, يُو, يو	votre	ڤوتر
your	يور, يُور, يور	la vôtre , le vôtre , les vôtres	لا ڤوتر ، لو ڤوتر ، لِ ڤوتر
yours	يورز, يُورز, يورز	vous-même	ڤو-مِم
yourself	يور سيلف, يُور سيلف, يور سِلف	il	إِل
he , it	هي, هِي, هِي	sa , son	سَا ، سُون
his	هِز, هِس, هِز	lui	لوي
him	هِم, هِم, هِم	le sien , la sienne , les siens , les siennes	لو سيَن ، لا سيَن ، لِ سيان ، لِ سيان
himself	هِم سيلف, هِم سِلف, هِم سيلف	lui-même	لوي-مِم
she , it	شي, شِي, شي	elle	إِل
her	هِر, هِر, هِر	la	لا
hers	هِرز, هِرز, هِرز	ils	إيل
herself	هِر سيلف, هِر سِلف, هِر سيلف	leur	لُر
they	ذِي, ذَي, ذِي	les	لِ
their	ذِير, ذير, ذِير	eux	أُو
them	ذِم, ذَم, ذِم	la leur , le leur , les leurs	لا لُر ، لو لُر ، لِ لُر
theirs	ذِيرز, ذيرز, ذِيرز	eux-même	أُو-مِم
themselves	ذِم سيلفز, ذِم سِلفز, ذِم سيلفز	elles	إِل
this	ذِس, ذِس, ذِس	leurs	لُر
these two	ذِيز تو, ذِيز تو, ذِيز تو	eux -même	أُو-مِم
these	ذِيز, ذِيز, ذِيز	ce , cet , ceci	سُو ، سِه ، سِسِي
those	ذوز, ذُوز, ذوز	cette , celle -ci	سِت ، سِل-سِي
who	هو, هُو, هُو	ces deux -là	سِ دُو-لا
whom	هُم, هُم, هُم	ces , ceux -ci	سِه ، سُو-سِي
there is ...	ذير إز ..., ذير إِز ..., ذير إز ...	cela , celui -là	سِلا ، سِلُوي-لا
there is not ...	ذير إز نوت ..., ذير إز نَت ..., ذير إز نوت ...	cela , celle -là	سِلا ، سِل-لا
fare	فِير, فَير, فَير	ceux , celles	سُو ، سِل
latest	ليتِست, لايتِست, ليتِست	on	أُون
sister	سِستر, سيستر, سِستر	qui	كِي
ear	إير, إِيَر, إير	il y a	إِل يَ أ
black	بلاك, بْلاك, بلاك	il n' y a pas	إِل نِي أ پَا
shoot	شوت, شُوت, شوت	tarif	تَارِيف
declare	دِكلير, ديكلير, دِكلير	soeur	سور
lend	لِند, لِند, لِند	oreille	أوراي
mother	ماذر, مَاذر, ماذر	noir	نُوار
son	سَن, سُن, سَن	tirer	تِيريه
daughter	دَوتر, دَاوتر, دَوتر	rendre	رَنْدغ
listen	لِسن, لِسِن, لِسن	déclarer	دِكلاريه
suggestion	سَجِستشن, سَجستشن, سَجِستشن	prêter	پْرِتِيه
procedure	بروسِدْيُور, بروسيديور, بروسِدْيُور	mère	مِير
diarrhea	دَياَريريا, دِياريَا, دَياَريريا	fils	فِيس
signal	سِجنل, سيجنل, سِجنل	fille	فِيل
extra	إكسترا, إِكسترا, إكسترا	écouter	إكوكتيه
tire	تاير, تِير, تاير	suggestion	سُجِسشيون
cancellation	كانسِليشن, كانسِليشن, كانسِليشن	procédure	پْروسِدور
english	إِنغليش, إِنگليش, إنغليش	diarrhée	دْياراي
flu	فلو, فْلو, فلو	feu	فُو
rest	ريست, رِست, ريست	supplémentaire	سُپليماںتير
telegram	تيليغرام, تِليغرام, تيليغرام	pneu	پْنُو
simple	سيمبل, سِمْبل, سيمبل	annulation	أَنولاسيون
skin	سكين, سْكين, سكين	anglais	أَنْگليه
onion	أونيون, أُونْيُون, أونيون	grippe	غْريب
visa	فيزا, فِيزا, فيزا	reste	رِست
remember	ريممبر, رِيممبر, ريممبر	échanger	إيشَانجِيه
ski	سكي, سْكي, سكي	télégramme	تِيلِغرام
registration	ريجستريشن, ريجِستريشن, ريجستريشن	peau	پُو
shopping	شوبينج, شوبِنج, شوبينج	oignon	أُنيُون
detail	ديتيل, دِيتيل, ديتيل	visa	ڤيزا
cost	كوست, كُوست, كوست	ski	سْكِي
tv	تي في, تِيفي, تي في	enregistrement	أَنْرِجِسترمَنْ
ice	آيس, أَيس, آيس	shopping	شوبِنغ
dry	دراي, دْرای, دراي	détail	دِتيال
university	يُنيڤرسيتي, يُنيڤرستي, يُنيڤرسيتي	coûter	كُوتيه
timetable	تايم تيبل, تَايْم تيبل, تايم تيبل	télé	تِيلِه
island	آيلاند, أَيلاند, آيلاند	glace	غْلاس
bridge	بريدج, بْريدج, بريدج	sec	سِك
shrimp	شرِمپ, شرمپ, شرِمپ	université	أُنِڤِرْسِتيه
quality	كواليتي, كوالِتي, كواليتي	horaire	أُورَاير
pocket	بوكيت, بُوكِت, بوكيت	île	إيل
bar	بار, بَار, بار	pont	پُون
porter	بورتر, بُورتر, بورتر	crevette	كْرِيفِت
bellboy	بيلبوي, بِل بوي, بيلبوي	qualité	كَالِيتِه
free	فري, فْري, فري	poche	پُوش
lettuce	ليتَس, لِتس, ليتَس	bar	بَار
serious	سيريَس, سِيريَس, سيريَس	porteur	پُورتر
back	باك, بَاك, باك	chasseur	شاسُر
lesson	ليسِن, لِسِن, ليسن	libre	لِيبغ
invite	إنڤايت, إِنڤايت, إنڤايت	laitue	لَيتُ
passenger	بَسِنجر, بَسِنجر, بَسِنجر	grave	غْرَاف
bet	بِت, بَت, بِت	arrière	أَرْيير
spring	سبرينج, سْبرينج, سبرينج	leçon	لِسُون
lobby	لُوبي, لوبي, لُوبي	inviter	أَنْڤِيتِيه
shelf	شيلف, شِلْف, شيلف	passager	پاسّاجيه
ride	رايد, راید, رايد	parier	پَارييه
sport	سبورت, سْبورت, سبورت	printemps	پْرِنطَام
butter	بتر, بَتَر, بتر	hall	هول
button	بَتَن, بَتُون, بَتَن	étagère	إِتاجِير
wife	وائف, وَايف, وائف	monter	مُونتِيه
travel	ترافِل, تْرافِل, ترافِل	sport	سْبُور
theft	ثِفت, ثَفت, ثِفت	beurre	بُغْر
happy	هَپي, هَبي, هَپي	bouton	بُوتُون
ship	شيب, شِيب, شيب	femme	فَام
knife	نايف, نَايْف, نايف	voyager	ڤُوياجِيه
stair	ستير, سْتير, ستير	heureux	أُرُو
earphone	إيرفون, إِيَرْفون, إيرفون	couteau	كُوتُو
movie theater	موفي ثيتر, موڤي ثيتر, موفي ثيتر	escalier	إِسكالييه
slice	سلايس, سْلايس, سلايس	écouteur	إِكُوتُور
thank	ثانك, ثَنْك, ثانك	cinéma	سِينِمَا
certificate	سيرتِفِكِت, سِرتِفِكِت, سيرتِفِكِت	tranche	تْرانش
famous	فييموس, فَيموس, فييموس	remercier	رُمْرسِييه
interesting	إنتريستينج, إِنترِستِنغ, إنتريستينج	certificat	سِرتِفِيكَا
health	هيلث, هِلث, هيلث	célèbre	سِيلِبر
TRUE	ترو, تْرُو, ترو	intéressant	أَنْتِرِسان
newspaper	نيوزبيپر, نيوسبِپر, نيوزبيپر	santé	سانتيه
row	رو, رُو, رو	vrai	ڤْرَي
sauce	سوس, سَوس, سوس	journal	ژُورنال
make	ميك, مِيك, ميك	rang	رَانغ
wool	وول, وُول, وول	sauce	سُوس
fishing	فِشينج, فيشينج, فِشينج	fabriquer	فَابريكِيه
tight	تايت, تَايْت, تايت	laine	لِين
emergency	إمِرجنسي, إيمرجنسي, إمِرجنسي	pêche	پِيش
student	ستودنت, سْتودنت, ستودنت	serré	سِرِّيه
counter	كاونتر, كَاونتر, كاونتر	les urgences	لِزُورجَانس
medical	ميديكال, مِدِكال, ميديكال	étudiant	إِتوديان
weather	ويذر, وِذَر, ويذر	comptoir	كُومطُوآر
length	لينث, لِنتث, لينث	médical	مِدِيكال
nail	نيل, نَيل, نيل	longueur	لُوغغُر
regular	ريجولار, ريجُلار, ريجولار	ongle	أُونغْل
world	وورلد, وُرلد, وورلد	normal	نُورمال
suffer	سَفِر, سَفِر, سَفِر	monde	مُوند
cart	كارت, كَارت, كارت	souffrir	سُوفغِير
member	ميمبر, مِمبر, ميمبر	compteur	كُومطُور
vacation	ڤيكيشن, فَكيشن, ڤيكيشن	chariot	شاريُو
sign	ساين, سَايْن, ساين	membre	مَامبْر
customer	كَستمر, كَستَمِر, كَستمر	vacance	فَاكَانس
gas	غاز, گاز, غاز	panneau	پَانُو
girl	جيرل, گِرل, جيرل	client	كْليان
cup	كَپ, كَپ, كَپ	essence	إِسَانس
towel	تاول, تاول, تاول	tasse	تَاس
vitamin	ڤيتامين, فِيتامين, ڤيتامين	serviette	سِرڤيت
meet	ميت, مِيت, مييت	vitamine	ڤِيتَامِين
appreciate	أپريسييت, أپْرِسييت, أپريشِيت	rencontrer	رَنْكونتر
story	ستوري, سْتوري, ستوري	coton	كُوتُون
short	شورت, شُورت, شورت	valeur	ڤالُر
spend	سْپيند, سپيند, سْپيند	cheville	شِڤيل
cotton	كاتن, كُتُن, كاتن	épaule	إِپول
value	ڤاليو, فَليو, ڤاليو	brochure	بْروشور
ankle	آنكل, أَنْكل, آنكل	balle	بَال
shoulder	شولدر, شُولدر, شولدر	chaise	شِيز
pamphlet	بَمفلت, بَامفلت, بَمفلت	gâteau	غَاتُ
ball	بول, بَول, بول	chien	شِيان
chair	تشير, چير, تشير	coupon	كُوپُون
cake	كيك, كَيْك, كيك	lentille de contact	لَنْتِيل دُ كُنتَاك
dog	دوغ, دُوغ, دوغ	jouet	جُوِيه
coupon	كُپون, كوبون, كُپون	jeu	جُو
contact lens	كونتاكت لنس, كُنتاكت لنس, كونتاكت لنس	conférence	كُونفِرانس
toy	توي, طوي, توي	montant	مُونتَان
conference	كونفرينس, كُنفرِنس, كونفرينس	vente	ڤَانت
amount	أَمَونت, أَمَاونت, أَمَونت	groupe	غْروب
sale	سيل, سَيْل, سيل	huître	يُتر
group , set	جروب, سيت, جروب / سيت	toilette	تُوالِت
oyster	أويستر, أُويستر, أويستر	voie	ڤُوا
toilet	تويليت, تويلت, تويليت	distance	دِستانس
pass	بَس, پَس, بَس	pièce	پِيس
track	تراك, تْراك, تراك	moutarde	مُوتَارْد
distance	دِستانس, دِستنس, دِستانس	pompe	پومب
mustard	مسترد, مَسترد, مسترد	pluie	پْلُوي
project	بروجيكت, پروجيكت, بروجيكت	raisonnable	رَيزُونابل
pump	بَمب, پَمب, بَمب	machine	مَاشِين
rain	رين, رَيْن, رين	fer à repasser	فِر أ رِپاسِيه
reasonable	ريزُنبل, رِيزونابل, ريزُنبل	sel	سِل
machine	ماشين, مَاشين, ماشين	cuillère	كُيِير
iron	آيرن, أَيرن, آيرن	excellent	إكْسِلَان
salt	سولت, سُلت, سولت	acteur	أَكتِور
spoon	سبون, سْبون, سبون	région	رِيجْيون
excellent	إكسلنت, إِكسلنت, إكسلنت	important	إِمْپُورطان
actor	آكتور, أَكتور, آكتور	mode	مُود
area	أيريا, أَرِيَا, أيريا	site	سِيت
important	إمبورتانت, إمپورتنت, إمبورتانت	coin	كُوان
fashion	فاشن, فَاشن, فاشن	fenêtre	فِنِيتْر
site	سايت, سَايت, سايت	plante	پْلانت
corner	كورنر, كُورنر, كورنر	végétarien	ڤِيجِتَارْيِين
window	ويندو, وِندو, ويندو	conseil	كُونسِيه
plant	بلانت, پْلانت, بلانت	regard , coup d' oeil	رِغارد ، كُو دُ وَي
vegetarian	ڤيجتيريان, فيجتيريان, ڤيجتيريان	propre	پروپغ
woman	وومَن, وُومَن, وومَن	rivière	رِڤيير
advice	أدفايس, أَدْفَيس, أدفايس	tranquille	تْرَانكِيل
look	لوك, لُوك, لوك	passe-temps	پاس-تَم
clean	كلين, كْلين, كلين	père	پِير
river	ريفر, رِڤر, ريفر	signer	سِينِييه
quiet	كوايت, كْوايت, كوايت	sujet	سُوژِه
hobby	هوبّي, هوبّي, هوبّي	comment	كُومَان
father	فاذر, فَاذر, فاذر	monsieur	مَسْيُور
waist	ويست, وِيست, ويست	madame	مَدام
matter	ماتر, مَاتر, ماتر	un peu	أَنْ پُ
how	هاو, هَاو, هاو	trop	تْرُو
mr. , sir	مِستر, سِر, مِستر / سِر	beaucoup	بُوكُو
ms. , maam	مِس, مام, مِس / مام	encore	أَنْكُور
a little bit	أ ليتل بِت, أَ ليتل بِت, أ ليتل بِت	falloir , prendre de temps , durer	فَالُوار ، پْرَنْدغ دُ تَم ، دُرِيه
too much	تو ماتش, تومَتش, تو ماتش	des frais	دِه فغغ
many , a lot	ميني, أ لوت, ميني / أ لوت	demi	دِمِي
still , yet	سْتِل, يِت, سْتِل / يِت	poste par avion	پُوست پَار أڤيُون
take , last	تيك, لاست, تيك / لاست	fois	فُواه
charges	تشارجز, چارجز, تشارجز	puis -je ... ?	پُوي-ژُ ... ؟
half	هاف, حاف, هاف	vraiment , certainement	ڤْرَيْمَان ، سِرتِنمَان
airmail	إيرميل, أيرميل, إيرميل	vraiment	ڤْرَيْمَان
may I ... ? , can I ... ?	مي آي ..., كَان آي ... ?, مي آي ..., كَان آي ... ?, مي آي ..., كَان آي ... ?	cher	شِير
might , may	مايت, مي, مايت / مي	avoir peur	أڤُوار پُر
already , for sure	ألردي, فور شور, ألردي / فور شور	touristique	تُورِيستيك
really	ريلي, رِيلي, ريلي	à destination de	أَ دِستِينَاسيون دُ
expensive	إكسپينسيف, إكسپينسِف, إكسپينسيف	revenir , retourner	رُوفُنِير ، رُتُرنِير
be afraid	بي آفريد, بي أَفْرِيد, بي آفريد	arrivée	أَريفِي
tourist , touristic	تورِست, توريستيك, تورِست / توريستيك	gauche	غُوش
bound to	باوند تو, بَوند تو, باوند تو	parfaitement , complètement	پَارفِيتْمَان ، كُومپلِتْمَان
return , come back	ريتورن, كم باك, ريتورن / كم باك	sur , à propos de	سُور ، أَ پْرُوپُو دُ
arrival	أَرایڤل, أَرَايڤل, أَرایڤل	pouvoir , être capable de	پُوفُوار ، إِتغ كَاپَابل دُ
left	لِفت, لِفْت, لِفت	moins	مُوَن
completely , perfectly	كومبليتلي, پرفِكتلي, كومبليتلي / پرفِكتلي	immédiatement	إِمِديَاتْمَان
can , be able to	كان, بي إيبِل تو, كان / بي إيبِل تو	bientôt	بِيانطُ
least , less	لِست, لِس, لِست / لِس	séjourner , descendre à	سِيجُورنِيه ، دِسَوندغ أ
right away	رايت أواي, رَيت أَواي, رايت أواي	nouvelles	نُوفِل
soon	سون, سُون, سون	compagnie aérienne	كُومپَانيه أِيرِيِن
news	نيوز, نْيوز, نيوز	fort	فُور
airline	إيرلاين, أيرلاين, إيرلاين	air	أِير
severe	سِفير, سِڤير, سِفير	moins cher	مُوَن شِير
air	إير, أَير, إير	attraper	أَتغَاپِيه
cheapest , cheaper	تشيپِست, تشِپر, تشيپِست / تشِپر	J' ai attrappé une maladie	ژه أِي أَتغَاپيه أُون مَالادِي
catch , hold	كاتش, هولد, كاتش / هولد	plus grand	پْلُو غْران
I caught a disease	آي كوت أ دِزيز, آي كاوت أ دِزيز, آي كوت أ دِزيز	convenable , aller bien	كُونڤنابل ، آلِي بِيان
biggest , bigger	بيجيست, بيگَر, بيجيست / بيگَر	bien	بِيان
largest , larger	لارجيست, لارجَر, لارجيست / لارجَر	forme	فُورم
suitable , appropriate , fit well	سوتِبل, أپروپريِت, فيت وِل, سوتِبل / أپروپريِت / فيت وِل	permettre	پَرْمِتغ
again	أگين, أَگِين, أگين	aller tout droit	آلِي تُو درُوَا
more	مور, مُور, مور	hier	يِير
shape	شَيْپ, شَيْپ, شَيْپ	dimanche	دِيمَنْش
allow	أَلَو, أَلَو, أَلَو	lundi	لَنْدِي
go straight	جو سترِيت, گو سترِيت, جو سترِيت	mardi	مَارْدِي
yesterday	يسترداي, يَستِرداي, يسترداي	mercredi	مِركرْدِي
sunday	ساندِ, سَنْدِ, ساندِ	jeudi	جُوِدِي
monday	ماندِي, مُندِي, ماندِي	vendredi	وََنْدْرِدِي
tuesday	تُوزدِي, تْيوزدِي, تُوزدِي	samedi	سَامْدِي
wednesday	وِنزدِي, وِينزدِي, وِنزدِي	janvier	ژَانڤِيِيه
thursday	ثُرزدِي, ثُرزدِي, ثُرزدِي	février	فِيفْرِيِيه
friday	فْرَيدِي, فْرِيدِي, فْرَيدِي	mars	مَارْس
saturday	سَتِردِي, سَتُردِي, سَتِردِي	avril	أَڤْرِيل
january	جانُاري, جانوري, جانُاري	mai	مَيه
february	فِبْرواري, فِبْرُواري, فِبْرواري	juin	جُوِين
march	مارتش, مَرْتش, مارتش	juillet	جُوِيِيه
april	إِيبرل, إِيبريل, إِيبرل	août	أُوت
may	ماي, مَاي, ماي	septembre	سَپْتَامْبْر
june	جون, جُون, جون	octobre	أُكتُوبْر
july	جُولاي, جُولاي, جُولاي	novembre	نُوفَامْبْر
august	أوغست, أُوغست, أوغست	décembre	دِسَامْبْر
september	سِبتَمبِر, سِپتَمبِر, سِبتَمبِر	achat	أَشَات
october	أوكتوبر, أُوكتوبر, أوكتوبر	obtenir	أُوبتْنِير
november	نوفَمبِر, نُوفَمبِر, نوفَمبِر	entrer	أَنْتْرِيه
december	ديسَمبِر, دِسَمبِر, ديسَمبِر	appeler	أَبَلِيه
purchase	پُرتشَس, پُرشَس, پُرتشَس	embarquement	أَنْبارْكْمَان
going	جوينج, گوينج, جوينج	bien sûr	بِيان سُور
getting	گيتنغ, گِتِنغ, گيتنغ	ne importé lequel	نُو اَمپورطِ لُكِل
entering	إنتَرِنغ, إِنترِنغ, إنتَرِنغ	gentil	جَنْتِي
calling	كولينغ, كولِنغ, كولينغ	le même	لُ مَم
changing	تشينجِنغ, تشَيْنجنغ, تشينجِنغ	plus tard	پْلُو تَار
seeing	سينينغ, سِيننغ, سينينغ	valise	ڤالِيز
boarding	بوردِنغ, بوردِينغ, بوردِنغ	loin	لُوَان
sending	سِنْدينغ, سِندِنغ, سِنْدينغ	dormir	دُورمِير
of course	أُف كُرس, أُف كورس, أُف كُرس	sommeil	سُومِيل
any	أَني, أَني, أَني	bleu	بْلُو
nice	نيس, نَايس, نيس	plus petit	پْلُو پْتِي
same	سِيم, سَيم, سِيم	vers le bas	فَر لُ بَاس
later	ليتِر, لِيتَر, ليتِر	ne importe quoi	نُ اَمپورط كُوَاه
suitcase	سويتكيس, سويتكيس, سويتكيس	faux	فُو
far	فار, فَار, فار	mademoiselle	مَادْمُوَاْزِل
sleep	سليب, سْليب, سليب	se garer	سُو غارِيه
blue	بلو, بْلو, بلو	choisir	شُوَازِير
smallest , smaller	سمالِست, سمالَر, سمالِست / سمالَر	plus ... que	پْلُو ... كُ
down	داون, دَاون, داون	populaire	پُوپُولِر
anything	أَنيثينغ, أَنيثينغ, أَنيثينغ	tard	تَار
wrong	رونغ, رُونغ, رونغ	se epuiser	سُو إِپُويزِيه
miss	مِس, مِس, مِس	terminer	تِرْمِينِيه
park	بارك, پَرك, بارك	mauvais	مُوفِيه
select , pick	سِلِكت, پِك, سِلِكت / پِك	certainement	سِرتِنمَان
more ... than	مور ثان, مُور ثان, مور ثان	ensemble	أَنْسَامْبْل
popular	پاپيلَر, پاپيولَر, پاپيلَر	suffire	سُفِير
late	ليت, لَيْت, ليت	prendre soin de	پْرَنْدْر سْوَا دُ
run out , end	رن آوت, إند, رن آوت / إند	station de taxi	سْتَاسْيُون دُ تَاكْسِي
bad	بَد, بَد, بَد	haut , élevé	أُو ، إِلِڤِيه
certainly	سِرتِنلي, سِرتِنلي, سِرتِنلي	déjà	دِيجَا
together	تُوگِذر, تُوگِذر, تُوگِذر	jamais	جَاميه
carry	كاري, كيري, كاري	pickpocket	پِيكپُوكِيه
enough	إناف, إِناف, إناف	marcher	مَارشِيه
take care	تيك كير, تِيك كير, تيك كير	allons-y	أَلُون-زِي
taxi stand	تاكسي ستاند, تاكسي ستَند, تاكسي ستاند	bienvenu	بِيانڤِنُو
high	هاي, هَاي, هاي	je vous en pris	ژُه فُو زَنْ پْرِيه
already	ألردي, أَلرِدي, ألردي	voici	فُواسي
never	نيفَر, نِفَر, نيفَر	penser	پَنْسِيه
pickpocket	پيكبُوكِت, پِيكپوكِت, پيكبُوكِت	réfléchir	رِفِلِشِيه
walk	ووك, وُوك, ووك	proche	پْروش
let 's go	لِتس گو, لِتس غُو, لِتس گو		
note	نوت, نُوت, نوت		
welcome	وِلکَم, وِلْكَم, وِلکَم		
you are welcome	يُو آر وِلکَم, يُو آر وِلْكَم, يُو آر وِلکَم		
here he is	هير هي إز, هير هي إِز, هير هي إز		
here she is	هير شي إز, هير شي إِز, هير شي إز		
believe	بِلِيف, بِلِڤ, بِلِيف		
near , close	نير, كلوز, نير / كلوز		